"a" = (/turf/open/floor/plating/asteroid/basalt,/area/lavaland/surface/outdoors)
"b" = (/mob/living/simple_animal/butterfly,/turf/open/floor/wood,/area/ruin/unpowered/caloriteshrine)
"c" = (/turf/open/floor/plasteel/stairs/right,/area/ruin/unpowered/caloriteshrine)
"f" = (/turf/open/floor/plasteel/stairs/medium,/area/ruin/unpowered/caloriteshrine)
"h" = (/obj/structure/flora/tree/jungle,/turf/open/floor/grass,/area/ruin/unpowered/caloriteshrine)
"j" = (/turf/open/floor/plasteel/stairs/left,/area/ruin/unpowered/caloriteshrine)
"l" = (/obj/structure/flora/ausbushes/sparsegrass,/turf/open/floor/grass,/area/ruin/unpowered/caloriteshrine)
"p" = (/obj/structure/flora/ausbushes/genericbush,/turf/open/floor/grass,/area/ruin/unpowered/caloriteshrine)
"r" = (/turf/open/indestructible/cobble/side{dir = 4},/area/ruin/unpowered/caloriteshrine)
"s" = (/turf/open/floor/wood,/area/ruin/unpowered/caloriteshrine)
"t" = (/obj/structure/flora/ausbushes/grassybush,/turf/open/floor/grass,/area/ruin/unpowered/caloriteshrine)
"u" = (/turf/closed/wall/mineral/calorite,/area/lavaland/surface/outdoors)
"y" = (/obj/effect/turf_decal/loading_area{icon_state = "drain"; name = "drain"},/turf/open/water,/area/ruin/unpowered/caloriteshrine)
"z" = (/turf/open/floor/mineral/crimsonstone_floor,/area/ruin/unpowered/caloriteshrine)
"E" = (/turf/open/floor/grass,/area/ruin/unpowered/caloriteshrine)
"G" = (/turf/closed/wall/mineral/calorite,/area/ruin/unpowered/caloriteshrine)
"H" = (/turf/open/indestructible/cobble,/area/ruin/unpowered/caloriteshrine)
"M" = (/obj/structure/flora/ausbushes/brflowers,/turf/open/floor/grass,/area/ruin/unpowered/caloriteshrine)
"N" = (/turf/open/water,/area/ruin/unpowered/caloriteshrine)
"O" = (/turf/open/indestructible/cobble/side{dir = 8},/area/ruin/unpowered/caloriteshrine)
"Q" = (/obj/structure/flora/tree/jungle/small,/obj/structure/flora/ausbushes/sparsegrass,/turf/open/floor/grass,/area/ruin/unpowered/caloriteshrine)
"R" = (/obj/structure/flora/ausbushes/reedbush,/turf/open/water,/area/ruin/unpowered/caloriteshrine)
"S" = (/mob/living/simple_animal/butterfly,/turf/open/floor/grass,/area/ruin/unpowered/caloriteshrine)
"T" = (/obj/structure/statue/calorite/fatty{anchored = 1},/obj/item/flashlight/lantern{anchored = 1; icon_state = null; icon = null},/turf/open/floor/mineral/calorite/strong,/area/ruin/unpowered/caloriteshrine)
"U" = (/obj/effect/turf_decal/loading_area{icon_state = "drain"; name = "drain"},/turf/closed/wall/mineral/calorite,/area/ruin/unpowered/caloriteshrine)
"V" = (/obj/structure/flora/tree/jungle/small,/turf/open/floor/grass,/area/ruin/unpowered/caloriteshrine)
"X" = (/turf/template_noop,/area/template_noop)

(1,1,1) = {"
XXXXXXXXXXXXXXXXXXXXXXXXXXXXXXXXXXXXXXXXXXXXX
XXXXXXXXXXXXXXXaaaaaaaaaaaaaaaXXXXXXXXXXXXXXX
XXXXXXXXXXXXXaaaGGGGGGGGGGGGGaaXXXXXXXXXXXXXX
XXXXXXXXXXXXXaaGGESlEEEEEEEEGGaaXXXXXaaaaXXXX
XXXXXXXXXXXXXaGGEEEEzzzzzEEEEGGaaaXXaaaaaaXXX
XXXXXXXXXXXXaaGEEEEzzzzzzzEEEEGaaaXaaaaaaaXXX
XXXXXXXXXXXXaaGEEEEzzzzzzzEEESGaaaaaaaaaaaXXX
XXXXXXXXXXXXaaGEEhEzzzzzzzlhEEGaaaaaaaaaaaXXX
XXXXXXXXXXXXaaGESlEzzzzzzzEElEGaaaaaaaaaaaXXX
XXXXXXXXXXXXaaGEEEEzzzzzzzEEEEGaaaaaaaaaaaXXX
XXXXXXXXXXXXaaGGlEEEzzzzzEEEEGGaaaaaaaaaaXXXX
XXXXXXXXXXXaaaGGGGGEEzzzlEGGGGGaaaaaaaaaXXXXX
XXXXXXXXXXXaaGGEEtUUUjfcUUUEMEGGaaaaaaXXXXXXX
XXXXXXXXXXXaaGEtEENNNOHrNNNEEStGaaaaXXXXXXXXX
XXXXXXXXXXaaGGEEQENTNOHrNTNlEEEGGaaaXXXXXXXXX
XXXXXXXXXXaaGMESEMNNNOHrNNNEEEEEGaaaXXXXXXXXX
XXXXXXXXXXaaGEEEEEsssOHrsssEEEQEGaaaXXXXXXXXX
XXXXXXXXXXaaGEEEEEsssOHrssbEEEEEGaaaXXXXXXXXX
XXXXXXXXXaaaGEMEEEsssOHrsssEEEMEGaaaXXXXXXXXX
XXXXXXXXXaaaGGEEtENNROHrNNNEVEEGGaaaXXXXXXXXX
XXXXXXXXXaaaaGtEESNTNOHrNTNEtSEGaaaXXXXXXXXXX
XXXXXXXXXXaaaGGEEEyyyOHryyyEEEGGaaXXXXXXXXXXX
XXXXXXXXXXXaaaGGEpGGGGHGGGGEMGGaaXXXXXXXXXXXX
XXXXXXXXXXXXaaaGGGGaaaaaaaGGGGaaaXXXXXXXXXXXX
XXXXXXXXXXXXXaaaaaaauaaauaaaaaaaXXXXXXXXXXXXX
XXXXXXXXXXXXXXaaaaaaaaaaaaaaaaaaXXXXXXXXXXXXX
XXXXXXXXXXXXXXXaaaaaaaaaaaaaaaaaXXXXXXXXXXXXX
XXXXXXXXXXXXXXXXXaaauaaauaaaaaaXXXXXXXXXXXXXX
XXXXXXXXXXXXXXXXXXXaaaaaaaaaaXXXXXXXXXXXXXXXX
"}
