//MAP CONVERTED BY dmm2tgm.py THIS HEADER COMMENT PREVENTS RECONVERSION, DO NOT REMOVE
"a" = (
/turf/open/floor/plasteel/cafeteria,
/area/space)
"h" = (
/obj/structure/table/wood,
/obj/machinery/light{
	dir = 8
	},
/turf/open/floor/wood,
/area/space)
"j" = (
/turf/closed/mineral/random/high_chance,
/area/space)
"k" = (
/turf/template_noop,
/area/space)
"m" = (
/obj/structure/table/reinforced,
/obj/machinery/light{
	dir = 8
	},
/turf/open/floor/wood,
/area/space)
"n" = (
/obj/structure/table/wood,
/turf/open/floor/wood,
/area/space)
"o" = (
/obj/machinery/light{
	dir = 4
	},
/turf/open/floor/wood,
/area/space)
"s" = (
/obj/structure/chair/stool,
/turf/open/floor/plating/asteroid/basalt/lava_land_surface,
/area/space)
"u" = (
/turf/open/floor/plating/asteroid/basalt/lava_land_surface,
/area/space)
"C" = (
/obj/structure/table/reinforced,
/turf/open/floor/wood,
/area/space)
"D" = (
/obj/machinery/light{
	dir = 1;
	light_color = "#cee5d2"
	},
/turf/open/floor/wood,
/area/space)
"E" = (
/turf/closed/wall,
/area/space)
"H" = (
/obj/structure/table/reinforced,
/obj/machinery/light{
	dir = 4
	},
/turf/open/floor/wood,
/area/space)
"R" = (
/turf/closed/mineral/random/low_chance,
/area/space)
"T" = (
/turf/open/floor/plasteel,
/area/space)
"U" = (
/turf/open/floor/wood,
/area/space)

(1,1,1) = {"
k
k
k
k
k
k
k
k
k
k
k
k
k
k
k
k
k
k
k
k
k
k
k
k
k
k
k
k
k
k
k
k
k
k
k
"}
(2,1,1) = {"
k
k
k
k
k
k
k
k
k
k
k
k
k
k
k
k
k
k
k
k
k
k
k
k
k
k
k
k
k
k
k
k
k
k
k
"}
(3,1,1) = {"
k
k
k
k
k
k
k
k
k
k
k
k
k
k
k
k
k
k
k
k
k
k
k
k
k
k
k
k
k
k
k
k
k
k
k
"}
(4,1,1) = {"
k
k
k
k
k
k
k
k
k
k
k
k
k
k
k
k
k
k
k
k
k
k
k
k
k
k
k
k
k
k
k
k
k
k
k
"}
(5,1,1) = {"
k
k
k
k
k
k
k
k
k
k
k
k
k
k
k
k
k
k
k
k
k
k
k
k
k
k
k
k
k
k
k
k
k
k
k
"}
(6,1,1) = {"
k
k
k
k
k
k
k
k
k
k
k
k
k
k
k
k
k
k
k
k
k
k
k
k
k
k
k
k
k
k
k
k
k
k
k
"}
(7,1,1) = {"
k
k
k
k
k
k
k
k
u
R
R
u
k
k
k
k
k
k
k
k
k
k
k
k
k
k
k
k
k
k
k
k
k
k
k
"}
(8,1,1) = {"
k
k
k
k
k
k
k
u
R
R
R
R
u
k
k
k
k
k
k
k
k
k
k
k
k
k
k
k
k
k
k
k
k
k
k
"}
(9,1,1) = {"
k
k
k
k
k
k
k
u
R
R
R
R
u
u
k
k
k
k
k
k
k
k
k
k
k
k
k
k
k
k
k
k
k
k
k
"}
(10,1,1) = {"
k
k
k
k
k
k
u
u
j
R
R
R
u
u
u
u
k
k
k
k
k
k
k
k
k
k
k
k
k
k
k
k
k
k
k
"}
(11,1,1) = {"
k
k
k
k
k
k
u
u
j
j
R
R
u
u
u
u
u
u
k
k
k
k
k
k
k
k
k
k
k
k
k
k
k
k
k
"}
(12,1,1) = {"
k
k
k
k
k
u
u
j
j
j
R
R
R
R
R
R
R
u
u
u
u
k
k
k
k
k
k
k
k
k
k
k
k
k
k
"}
(13,1,1) = {"
k
k
k
k
k
u
u
j
j
j
j
R
R
R
R
R
R
R
R
R
u
u
k
k
k
k
k
k
k
k
k
k
k
k
k
"}
(14,1,1) = {"
k
k
k
k
k
u
u
j
j
j
j
R
R
R
R
R
R
R
R
R
R
u
u
u
k
k
u
u
u
u
k
k
k
k
k
"}
(15,1,1) = {"
k
k
k
k
u
u
j
j
j
j
j
R
R
E
E
E
E
E
E
E
u
u
u
u
u
u
u
u
u
u
u
k
k
k
k
"}
(16,1,1) = {"
k
k
k
u
u
j
j
j
j
j
R
R
R
E
n
h
n
h
n
E
u
u
u
u
u
u
u
u
u
u
u
u
k
k
k
"}
(17,1,1) = {"
k
k
k
u
u
j
j
j
j
j
R
R
R
E
U
U
U
U
U
E
u
u
u
u
u
u
u
u
u
u
u
u
k
k
k
"}
(18,1,1) = {"
k
k
k
u
u
j
j
j
j
j
R
R
R
E
U
U
U
U
U
m
s
u
u
u
u
u
u
u
u
u
u
u
k
k
k
"}
(19,1,1) = {"
k
k
k
k
u
j
j
j
j
R
R
R
R
E
U
U
U
U
U
C
s
u
u
u
u
u
u
u
u
u
u
u
k
k
k
"}
(20,1,1) = {"
k
k
k
k
u
j
j
j
j
R
R
R
R
E
D
U
U
U
U
C
s
u
u
u
u
u
u
u
u
u
u
u
k
k
k
"}
(21,1,1) = {"
k
k
k
k
u
j
j
j
R
R
R
R
R
E
U
U
U
U
U
C
s
u
u
u
u
u
u
u
u
u
u
u
k
k
k
"}
(22,1,1) = {"
k
k
k
k
u
j
j
j
R
E
E
E
E
E
U
U
U
U
U
H
s
u
u
u
u
u
u
u
u
u
u
u
k
k
k
"}
(23,1,1) = {"
k
k
k
k
u
j
j
R
R
E
a
a
a
a
U
U
U
U
U
E
u
u
u
u
u
u
u
u
u
u
u
k
k
k
k
"}
(24,1,1) = {"
k
k
k
k
k
u
j
R
R
E
a
a
a
E
U
o
U
o
U
E
u
u
u
u
u
u
u
u
u
u
k
k
k
k
k
"}
(25,1,1) = {"
k
k
k
k
k
u
j
R
R
E
a
a
a
E
E
E
T
E
E
E
u
u
u
u
u
u
u
u
u
u
k
k
k
k
k
"}
(26,1,1) = {"
k
k
k
k
k
u
j
R
R
E
a
a
a
E
T
T
T
T
T
E
u
u
u
u
u
u
R
R
R
u
k
k
k
k
k
"}
(27,1,1) = {"
k
k
k
k
k
u
j
R
R
E
a
a
a
E
T
T
T
T
T
T
u
u
u
u
u
u
R
R
j
u
k
k
k
k
k
"}
(28,1,1) = {"
k
k
k
k
k
u
j
R
R
E
a
a
a
E
T
T
T
T
T
E
u
u
u
u
u
u
R
R
R
u
k
k
k
k
k
"}
(29,1,1) = {"
k
k
k
k
u
u
j
R
R
E
E
E
E
E
E
E
E
E
E
E
R
j
u
u
R
j
R
R
R
u
k
k
k
k
k
"}
(30,1,1) = {"
k
k
k
k
u
u
j
j
R
R
R
R
R
R
R
R
j
j
R
R
R
R
j
j
j
j
j
R
R
u
k
k
k
k
k
"}
(31,1,1) = {"
k
k
k
k
u
j
j
j
R
R
R
R
R
R
R
R
R
j
j
R
R
R
R
R
j
j
j
R
R
u
k
k
k
k
k
"}
(32,1,1) = {"
k
k
k
u
u
j
j
j
j
j
R
R
R
R
j
j
j
j
j
j
R
R
R
R
R
j
j
j
u
u
k
k
k
k
k
"}
(33,1,1) = {"
k
k
k
u
j
j
j
j
j
j
j
R
j
j
j
j
j
j
j
R
R
R
R
R
R
R
R
j
u
k
k
k
k
k
k
"}
(34,1,1) = {"
k
k
k
u
u
j
j
R
j
j
j
j
j
j
j
j
j
j
j
j
R
R
R
R
R
R
u
u
u
k
k
k
k
k
k
"}
(35,1,1) = {"
k
k
k
u
u
u
R
R
R
R
R
j
j
j
j
j
j
u
u
u
u
u
u
u
u
u
u
u
u
k
k
k
k
k
k
"}
(36,1,1) = {"
k
k
k
k
k
u
u
R
R
R
j
j
j
j
u
u
u
u
u
u
u
u
u
u
u
u
u
u
k
k
k
k
k
k
k
"}
(37,1,1) = {"
k
k
k
k
k
u
u
R
R
j
j
j
u
u
u
u
u
u
k
u
u
u
u
k
k
u
u
k
k
k
k
k
k
k
k
"}
(38,1,1) = {"
k
k
k
k
k
k
u
R
R
j
j
u
u
u
u
u
u
k
k
k
u
u
k
k
k
k
k
k
k
k
k
k
k
k
k
"}
(39,1,1) = {"
k
k
k
k
k
k
u
R
R
u
u
u
u
u
u
u
k
k
k
k
u
k
k
k
k
k
k
k
k
k
k
k
k
k
k
"}
(40,1,1) = {"
k
k
k
k
k
k
u
u
u
u
u
k
u
u
u
k
k
k
k
k
k
k
k
k
k
k
k
k
k
k
k
k
k
k
k
"}
(41,1,1) = {"
k
k
k
k
k
k
k
u
u
k
k
k
k
k
u
k
k
k
k
k
k
k
k
k
k
k
k
k
k
k
k
k
k
k
k
"}
(42,1,1) = {"
k
k
k
k
k
k
k
k
k
k
k
k
k
k
u
k
k
k
k
k
k
k
k
k
k
k
k
k
k
k
k
k
k
k
k
"}
(43,1,1) = {"
k
k
k
k
k
k
k
k
k
k
k
k
k
k
k
k
k
k
k
k
k
k
k
k
k
k
k
k
k
k
k
k
k
k
k
"}
(44,1,1) = {"
k
k
k
k
k
k
k
k
k
k
k
k
k
k
k
k
k
k
k
k
k
k
k
k
k
k
k
k
k
k
k
k
k
k
k
"}
(45,1,1) = {"
k
k
k
k
k
k
k
k
k
k
k
k
k
k
k
k
k
k
k
k
k
k
k
k
k
k
k
k
k
k
k
k
k
k
k
"}
(46,1,1) = {"
k
k
k
k
k
k
k
k
k
k
k
k
k
k
k
k
k
k
k
k
k
k
k
k
k
k
k
k
k
k
k
k
k
k
k
"}
(47,1,1) = {"
k
k
k
k
k
k
k
k
k
k
k
k
k
k
k
k
k
k
k
k
k
k
k
k
k
k
k
k
k
k
k
k
k
k
k
"}
(48,1,1) = {"
k
k
k
k
k
k
k
k
k
k
k
k
k
k
k
k
k
k
k
k
k
k
k
k
k
k
k
k
k
k
k
k
k
k
k
"}
(49,1,1) = {"
k
k
k
k
k
k
k
k
k
k
k
k
k
k
k
k
k
k
k
k
k
k
k
k
k
k
k
k
k
k
k
k
k
k
k
"}
(50,1,1) = {"
k
k
k
k
k
k
k
k
k
k
k
k
k
k
k
k
k
k
k
k
k
k
k
k
k
k
k
k
k
k
k
k
k
k
k
"}
