//MAP CONVERTED BY dmm2tgm.py THIS HEADER COMMENT PREVENTS RECONVERSION, DO NOT REMOVE
"a" = (
/turf/closed/mineral/volcanic/lava_land_surface,
/area/lavaland/surface/outdoors)
"b" = (
/turf/open/floor/plating/asteroid/basalt/lava_land_surface,
/area/lavaland/surface/outdoors)
"c" = (
/turf/open/lava/smooth/lava_land_surface,
/area/lavaland/surface/outdoors)
"d" = (
/obj/effect/turf_decal/tile/brown{
	dir = 8
	},
/turf/open/floor/plasteel,
/area/ruin/powered/gluttony)
"e" = (
/turf/open/lava/smooth,
/area/ruin/powered/gluttony)
"f" = (
/obj/item/reagent_containers/syringe/gluttony{
	pixel_y = -6
	},
/obj/item/reagent_containers/glass/beaker/lipoifier{
	pixel_y = 8
	},
/turf/open/floor/mineral/calorite/hide,
/area/ruin/powered/gluttony)
"g" = (
/obj/effect/gluttony,
/turf/open/floor/mineral/basaltstone_floor,
/area/ruin/powered/gluttony)
"h" = (
/obj/item/veilrender/vealrender,
/obj/effect/turf_decal/tile/brown{
	dir = 1
	},
/obj/effect/turf_decal/tile/brown{
	dir = 4
	},
/obj/effect/turf_decal/tile/brown{
	dir = 8
	},
/turf/open/floor/plasteel,
/area/ruin/powered/gluttony)
"i" = (
/turf/open/floor/mineral/basaltstone_floor,
/area/ruin/powered/gluttony)
"j" = (
/obj/item/trash/plate,
/obj/effect/turf_decal/tile/brown{
	dir = 1
	},
/obj/effect/turf_decal/tile/brown{
	dir = 4
	},
/turf/open/floor/plasteel,
/area/ruin/powered/gluttony)
"k" = (
/turf/closed/wall/mineral/calorite,
/area/ruin/powered/gluttony)
"l" = (
/obj/item/trash/candy,
/obj/effect/turf_decal/tile/brown{
	dir = 1
	},
/obj/effect/turf_decal/tile/brown{
	dir = 8
	},
/turf/open/floor/plasteel,
/area/ruin/powered/gluttony)
"m" = (
/obj/item/trash/raisins,
/obj/effect/turf_decal/tile/brown,
/obj/effect/turf_decal/tile/brown{
	dir = 8
	},
/turf/open/floor/plasteel,
/area/ruin/powered/gluttony)
"n" = (
/obj/item/trash/pistachios,
/turf/open/floor/mineral/basaltstone_floor,
/area/ruin/powered/gluttony)
"o" = (
/obj/item/trash/popcorn,
/obj/effect/turf_decal/tile/brown,
/obj/effect/turf_decal/tile/brown{
	dir = 8
	},
/obj/effect/turf_decal/tile/brown{
	dir = 1
	},
/turf/open/floor/plasteel,
/area/ruin/powered/gluttony)
"p" = (
/obj/item/trash/semki,
/obj/effect/turf_decal/tile/brown{
	dir = 1
	},
/obj/effect/turf_decal/tile/brown{
	dir = 8
	},
/turf/open/floor/plasteel,
/area/ruin/powered/gluttony)
"q" = (
/obj/item/trash/syndi_cakes,
/obj/effect/turf_decal/tile/brown,
/obj/effect/turf_decal/tile/brown{
	dir = 4
	},
/obj/effect/turf_decal/tile/brown{
	dir = 8
	},
/turf/open/floor/plasteel,
/area/ruin/powered/gluttony)
"r" = (
/obj/effect/gluttony,
/obj/machinery/light/small{
	dir = 1
	},
/obj/effect/turf_decal/tile/brown{
	dir = 1
	},
/obj/effect/turf_decal/tile/brown{
	dir = 4
	},
/turf/open/floor/plasteel,
/area/ruin/powered/gluttony)
"t" = (
/obj/machinery/light/small{
	dir = 1
	},
/obj/effect/turf_decal/tile/brown{
	dir = 1
	},
/obj/effect/turf_decal/tile/brown{
	dir = 4
	},
/turf/open/floor/plasteel,
/area/ruin/powered/gluttony)
"u" = (
/obj/effect/turf_decal/tile/brown{
	dir = 1
	},
/obj/effect/turf_decal/tile/brown{
	dir = 4
	},
/obj/effect/turf_decal/tile/brown,
/turf/open/floor/plasteel,
/area/ruin/powered/gluttony)
"v" = (
/obj/machinery/light/small,
/obj/effect/turf_decal/tile/brown,
/obj/effect/turf_decal/tile/brown{
	dir = 8
	},
/turf/open/floor/plasteel,
/area/ruin/powered/gluttony)
"x" = (
/obj/effect/gluttony,
/turf/open/floor/mineral/calorite/hide,
/area/ruin/powered/gluttony)
"z" = (
/obj/item/trash/plate,
/obj/machinery/light/small{
	dir = 8
	},
/obj/effect/turf_decal/tile/brown{
	dir = 1
	},
/obj/effect/turf_decal/tile/brown{
	dir = 8
	},
/turf/open/floor/plasteel,
/area/ruin/powered/gluttony)
"A" = (
/obj/machinery/light/small{
	dir = 4
	},
/obj/effect/turf_decal/tile/brown,
/obj/effect/turf_decal/tile/brown{
	dir = 4
	},
/turf/open/floor/plasteel,
/area/ruin/powered/gluttony)
"B" = (
/obj/effect/turf_decal/tile/brown{
	dir = 1
	},
/obj/effect/turf_decal/tile/brown{
	dir = 4
	},
/turf/open/floor/plasteel,
/area/ruin/powered/gluttony)
"C" = (
/obj/effect/gluttony,
/obj/effect/turf_decal/tile/brown{
	dir = 1
	},
/obj/effect/turf_decal/tile/brown{
	dir = 4
	},
/turf/open/floor/plasteel,
/area/ruin/powered/gluttony)
"D" = (
/obj/effect/turf_decal/tile/brown{
	dir = 1
	},
/obj/effect/turf_decal/tile/brown{
	dir = 8
	},
/turf/open/floor/plasteel,
/area/ruin/powered/gluttony)
"E" = (
/obj/item/trash/candy,
/obj/effect/turf_decal/tile/brown,
/obj/effect/turf_decal/tile/brown{
	dir = 4
	},
/turf/open/floor/plasteel,
/area/ruin/powered/gluttony)
"F" = (
/obj/effect/turf_decal/tile/brown{
	dir = 4
	},
/obj/effect/turf_decal/tile/brown,
/obj/effect/gluttony,
/turf/open/floor/mineral/calorite/hide,
/area/ruin/powered/gluttony)
"G" = (
/obj/effect/turf_decal/tile/brown{
	dir = 4
	},
/obj/effect/gluttony,
/turf/open/floor/plasteel,
/area/ruin/powered/gluttony)
"H" = (
/obj/item/trash/candy,
/turf/open/floor/mineral/basaltstone_floor,
/area/ruin/powered/gluttony)
"I" = (
/obj/item/trash/raisins,
/turf/open/floor/mineral/basaltstone_floor,
/area/ruin/powered/gluttony)
"K" = (
/obj/effect/turf_decal/tile/brown,
/obj/effect/turf_decal/tile/brown{
	dir = 8
	},
/turf/open/floor/plasteel,
/area/ruin/powered/gluttony)
"L" = (
/obj/effect/turf_decal/tile/brown,
/obj/effect/turf_decal/tile/brown{
	dir = 4
	},
/turf/open/floor/plasteel,
/area/ruin/powered/gluttony)
"O" = (
/obj/machinery/light/small{
	dir = 1
	},
/obj/effect/turf_decal/tile/brown{
	dir = 1
	},
/obj/effect/turf_decal/tile/brown{
	dir = 8
	},
/obj/effect/gluttony,
/turf/open/floor/mineral/calorite/hide,
/area/ruin/powered/gluttony)
"P" = (
/obj/effect/turf_decal/tile/brown,
/obj/effect/turf_decal/tile/brown{
	dir = 8
	},
/obj/effect/turf_decal/tile/brown{
	dir = 4
	},
/turf/open/floor/plasteel,
/area/ruin/powered/gluttony)
"R" = (
/obj/structure/statue/calorite/fatty,
/obj/item/book/granter/spell/fattening/transfer,
/turf/open/floor/mineral/calorite/hide,
/area/ruin/powered/gluttony)
"S" = (
/obj/structure/fans/tiny/invisible,
/obj/structure/mineral_door/calorite,
/turf/open/floor/mineral/basaltstone_floor,
/area/ruin/powered/gluttony)
"T" = (
/obj/effect/turf_decal/tile/brown{
	dir = 1
	},
/obj/effect/gluttony,
/turf/open/floor/plasteel,
/area/ruin/powered/gluttony)
"U" = (
/obj/effect/turf_decal/tile/brown{
	dir = 1
	},
/obj/effect/turf_decal/tile/brown{
	dir = 4
	},
/obj/effect/gluttony,
/turf/open/floor/plasteel,
/area/ruin/powered/gluttony)
"V" = (
/obj/effect/turf_decal/tile/brown{
	dir = 1
	},
/obj/effect/turf_decal/tile/brown{
	dir = 8
	},
/obj/effect/gluttony,
/turf/open/floor/mineral/calorite/hide,
/area/ruin/powered/gluttony)
"W" = (
/obj/effect/turf_decal/tile/brown{
	dir = 1
	},
/obj/effect/turf_decal/tile/brown{
	dir = 8
	},
/obj/effect/turf_decal/tile/brown,
/turf/open/floor/plasteel,
/area/ruin/powered/gluttony)
"X" = (
/obj/machinery/light/small{
	dir = 1
	},
/obj/effect/turf_decal/tile/brown{
	dir = 4
	},
/obj/effect/turf_decal/tile/brown,
/obj/effect/gluttony,
/turf/open/floor/mineral/calorite/hide,
/area/ruin/powered/gluttony)
"Y" = (
/obj/effect/gluttony,
/obj/effect/turf_decal/tile/brown,
/turf/open/floor/plasteel,
/area/ruin/powered/gluttony)

(1,1,1) = {"
a
a
a
b
b
a
a
b
a
b
b
b
b
b
b
b
a
a
a
a
"}
(2,1,1) = {"
a
a
a
b
b
b
b
b
b
b
b
b
b
b
b
b
a
a
a
a
"}
(3,1,1) = {"
b
a
a
a
b
b
b
c
c
c
b
c
c
c
b
b
a
a
a
a
"}
(4,1,1) = {"
b
a
a
a
b
b
b
c
k
k
S
k
k
c
b
a
a
a
a
a
"}
(5,1,1) = {"
b
b
a
a
a
b
b
c
k
h
i
o
k
c
b
a
a
a
a
a
"}
(6,1,1) = {"
a
a
a
a
a
b
b
c
k
B
i
v
k
c
b
b
b
b
b
a
"}
(7,1,1) = {"
a
b
b
b
b
b
b
c
k
B
H
K
k
c
b
b
b
b
b
a
"}
(8,1,1) = {"
b
b
c
c
c
c
c
c
k
t
i
m
k
c
c
c
c
c
c
b
"}
(9,1,1) = {"
b
c
c
k
k
k
k
k
k
U
I
v
k
k
k
k
k
k
c
b
"}
(10,1,1) = {"
b
c
k
k
e
k
O
V
V
T
g
d
p
D
z
l
W
k
c
b
"}
(11,1,1) = {"
b
c
k
R
f
x
x
x
x
g
n
i
i
i
i
i
i
S
b
b
"}
(12,1,1) = {"
b
c
k
k
e
k
X
F
F
G
i
Y
L
E
A
L
q
k
c
b
"}
(13,1,1) = {"
b
c
c
k
k
k
k
k
k
C
i
v
k
k
k
k
k
k
c
b
"}
(14,1,1) = {"
b
b
c
c
c
c
c
c
k
r
i
K
k
c
c
c
c
c
c
b
"}
(15,1,1) = {"
a
b
b
b
b
b
b
c
k
B
g
K
k
c
b
b
b
b
b
b
"}
(16,1,1) = {"
b
b
b
a
b
b
b
c
k
j
i
v
k
c
b
b
b
a
a
a
"}
(17,1,1) = {"
b
b
b
a
b
b
b
c
k
u
n
P
k
c
b
b
b
a
a
a
"}
(18,1,1) = {"
a
a
a
a
b
b
b
c
k
k
S
k
k
c
b
b
b
a
a
a
"}
(19,1,1) = {"
a
a
a
a
a
a
a
c
c
c
b
c
c
c
b
b
a
a
a
a
"}
(20,1,1) = {"
a
a
a
a
a
a
a
b
b
b
b
b
b
b
a
a
b
a
a
a
"}
