//MAP CONVERTED BY dmm2tgm.py THIS HEADER COMMENT PREVENTS RECONVERSION, DO NOT REMOVE
"aa" = (
/turf/template_noop,
/area/template_noop)
"ab" = (
/turf/closed/mineral/random/low_chance,
/area/ruin/unpowered)
"ac" = (
/obj/machinery/hydroponics/soil,
/turf/open/floor/plating/asteroid,
/area/ruin/unpowered)
"ad" = (
/obj/structure/table/wood,
/obj/item/shovel,
/turf/open/floor/plating/asteroid,
/area/ruin/unpowered)
"ae" = (
/turf/closed/wall/mineral/titanium,
/area/ruin/powered)
"af" = (
/obj/effect/spawner/structure/window/shuttle,
/turf/open/floor/mineral/titanium,
/area/ruin/powered)
"ag" = (
/obj/structure/shuttle/engine/propulsion/right{
	dir = 4
	},
/turf/closed/wall/mineral/titanium,
/area/ruin/powered)
"ah" = (
/turf/open/floor/plating/asteroid,
/area/ruin/unpowered)
"ai" = (
/obj/structure/lattice,
/turf/template_noop,
/area/template_noop)
"aj" = (
/obj/machinery/computer/cryopod,
/turf/closed/wall/mineral/titanium,
/area/ruin/powered)
"ak" = (
/obj/structure/fluff/empty_cryostasis_sleeper,
/turf/open/floor/mineral/titanium,
/area/ruin/powered)
"al" = (
/obj/machinery/status_display/shuttle,
/turf/closed/wall/mineral/titanium,
/area/ruin/powered)
"am" = (
/obj/item/seeds/tower,
/obj/item/seeds/tower,
/obj/item/seeds/tower,
/turf/open/floor/plating/asteroid,
/area/ruin/unpowered)
"an" = (
/turf/open/floor/mineral/titanium,
/area/ruin/powered)
"ao" = (
/obj/structure/chair/comfy/shuttle{
	dir = 8
	},
/turf/open/floor/mineral/titanium,
/area/ruin/powered)
"ap" = (
/obj/machinery/light{
	dir = 1
	},
/turf/open/floor/mineral/titanium,
/area/ruin/powered)
"aq" = (
/obj/machinery/computer{
	desc = "A computer long since rendered non-functional due to lack of maintenance. Spitting out error messages.";
	dir = 4;
	name = "Broken Computer"
	},
/turf/open/floor/mineral/titanium,
/area/ruin/powered)
"ar" = (
/obj/machinery/door/airlock/titanium{
	name = "Escape Pod Airlock"
	},
/obj/machinery/poweredfans,
/turf/open/floor/mineral/titanium,
/area/ruin/powered)
"as" = (
/obj/machinery/light,
/turf/open/floor/mineral/titanium,
/area/ruin/powered)
"at" = (
/obj/structure/shuttle/engine/propulsion/left{
	dir = 4
	},
/turf/closed/wall/mineral/titanium,
/area/ruin/powered)
"au" = (
/obj/item/stack/sheet/mineral/wood,
/obj/item/stack/sheet/mineral/wood,
/obj/item/stack/sheet/mineral/wood,
/obj/item/stack/sheet/mineral/wood,
/obj/item/stack/sheet/mineral/wood,
/turf/open/floor/plating/asteroid,
/area/ruin/unpowered)
"av" = (
/obj/item/twohanded/spear,
/turf/open/floor/plating/asteroid,
/area/ruin/unpowered)
"aw" = (
/obj/item/grown/log,
/obj/item/grown/log,
/turf/open/floor/plating/asteroid,
/area/ruin/unpowered)
"ax" = (
/obj/structure/table/wood,
/obj/item/storage/bag/plants/portaseeder,
/turf/open/floor/plating/asteroid,
/area/ruin/unpowered)
"ay" = (
/obj/item/flashlight/lamp/bananalamp,
/turf/open/floor/plating/asteroid,
/area/ruin/unpowered)
"az" = (
/obj/item/seeds/banana,
/obj/item/seeds/banana,
/turf/open/floor/plating/asteroid,
/area/ruin/unpowered)
"aA" = (
/turf/open/floor/plating/asteroid/airless,
/area/ruin/unpowered)
"aB" = (
/obj/effect/mob_spawn/human/clown/corpse,
/obj/structure/fans/tiny/invisible,
/turf/open/floor/plating/asteroid,
/area/ruin/unpowered)
"aC" = (
/obj/item/mining_scanner,
/turf/open/floor/plating/asteroid,
/area/ruin/unpowered)
"aD" = (
/obj/item/circuitboard/computer/rdconsole,
/obj/item/circuitboard/machine/protolathe/department/science,
/turf/open/floor/plating/asteroid,
/area/ruin/unpowered)
"aE" = (
/obj/machinery/status_display/shuttle,
/turf/closed/wall/mineral/titanium,
/area/ruin/unpowered)
"aF" = (
/obj/item/pickaxe/emergency,
/turf/open/floor/plating/asteroid,
/area/ruin/unpowered)
"aG" = (
/obj/structure/sink/puddle,
/turf/open/floor/plating/asteroid,
/area/ruin/unpowered)
"aH" = (
/obj/structure/table/wood,
/obj/item/storage/firstaid/regular,
/turf/open/floor/plating/asteroid,
/area/ruin/unpowered)
"aI" = (
/obj/effect/mob_spawn/human/corpse/assistant,
/turf/template_noop,
/area/template_noop)
"aJ" = (
/obj/structure/table/wood,
/obj/item/storage/bag/ore,
/turf/open/floor/plating/asteroid,
/area/ruin/unpowered)
"aK" = (
/obj/structure/reagent_dispensers/fueltank,
/turf/open/floor/plating/asteroid,
/area/ruin/unpowered)
"aL" = (
/obj/structure/table/wood,
/obj/item/storage/toolbox/mechanical,
/obj/item/clothing/head/welding,
/turf/open/floor/plating/asteroid,
/area/ruin/unpowered)
"aM" = (
/mob/living/simple_animal/hostile/carp,
/turf/template_noop,
/area/template_noop)
"aN" = (
/obj/structure/mineral_door/sandstone,
/turf/open/floor/plating/asteroid,
/area/ruin/unpowered)
"aO" = (
/mob/living/simple_animal/hostile/carp,
/turf/open/floor/plating/asteroid/airless,
/area/ruin/unpowered)
"aP" = (
/obj/item/stack/ore/gold,
/turf/open/floor/plating/asteroid,
/area/ruin/unpowered)
"aQ" = (
/obj/item/stack/ore/gold,
/obj/item/stack/ore/gold,
/obj/item/stack/ore/gold,
/turf/open/floor/plating/asteroid,
/area/ruin/unpowered)
"aR" = (
/obj/item/stack/ore/iron,
/turf/open/floor/plating/asteroid,
/area/ruin/unpowered)
"aS" = (
/turf/closed/wall/mineral/iron,
/area/ruin/unpowered)
"aT" = (
/obj/item/stack/ore/iron,
/obj/item/stack/ore/iron,
/turf/open/floor/plating/asteroid,
/area/ruin/unpowered)
"aU" = (
/obj/item/flashlight/lamp,
/obj/structure/table/wood,
/turf/open/floor/plating/asteroid,
/area/ruin/unpowered)
"aV" = (
/obj/item/clothing/suit/space/orange,
/obj/item/clothing/head/helmet/space/orange{
	pixel_y = 12;
	pixel_x = -7
	},
/turf/template_noop,
/area/template_noop)
"aW" = (
/obj/structure/chair/comfy/shuttle{
	dir = 8
	},
/obj/item/clothing/suit/space/orange,
/turf/open/floor/mineral/titanium,
/area/ruin/powered)
"aX" = (
/mob/living/simple_animal/hostile/carp/megacarp,
/turf/template_noop,
/area/template_noop)
"aY" = (
/obj/effect/mob_spawn/human/hermit{
	flavour_text = "You've been late to awaken from your cryo slumber. Blasted machine, you set it to 10 days not 10 weeks! Where have the others gone while we were out? Did they manage to survive? These thoughts are dispelled by yet another recollection of how you got here... ";
	job_description = "Space Hermit"
	},
/turf/open/floor/mineral/titanium,
/area/ruin/powered)
"aZ" = (
/turf/closed/wall/mineral/titanium,
/area/ruin/unpowered)
"ba" = (
/obj/effect/spawner/structure/window/shuttle,
/turf/open/floor/mineral/titanium,
/area/ruin/unpowered)
"bb" = (
/obj/structure/shuttle/engine/propulsion/left{
	dir = 4
	},
/turf/closed/wall/mineral/titanium,
/area/ruin/unpowered)
"bc" = (
/obj/structure/table/wood,
/obj/item/pen,
/obj/item/bluespace_thread{
	pixel_x = -1;
	pixel_y = 1
	},
/turf/open/floor/plating/asteroid,
/area/ruin/unpowered)
"bd" = (
/obj/item/circuitboard/machine/circuit_imprinter,
/turf/open/floor/plating/asteroid,
/area/ruin/unpowered)
"be" = (
/obj/item/grown/bananapeel,
/turf/open/floor/plating/asteroid,
/area/ruin/unpowered)
"bf" = (
/obj/effect/mob_spawn/human/corpse/cargo_tech,
/obj/structure/fans/tiny/invisible,
/obj/effect/decal/cleanable/vomit,
/turf/open/floor/plating/asteroid,
/area/ruin/unpowered)
"bg" = (
/obj/item/clothing/glasses/meson,
/turf/open/floor/plating/asteroid,
/area/ruin/unpowered)
"bh" = (
/obj/item/circuitboard/machine/autolathe,
/turf/open/floor/mineral/titanium,
/area/ruin/powered)
"bi" = (
/obj/item/stock_parts/matter_bin,
/turf/open/floor/plating/asteroid,
/area/ruin/unpowered)
"bj" = (
/obj/item/stock_parts/manipulator,
/turf/open/floor/plating/asteroid,
/area/ruin/unpowered)
"bk" = (
/obj/structure/holosign/barrier/atmos,
/turf/open/floor/plating/asteroid,
/area/ruin/unpowered)
"bl" = (
/obj/item/holosign_creator/atmos,
/turf/open/floor/plating/asteroid,
/area/ruin/unpowered)
"bm" = (
/obj/machinery/power/floodlight,
/obj/structure/cable{
	icon_state = "0-2"
	},
/turf/open/floor/plating/asteroid,
/area/ruin/unpowered)
"bn" = (
/obj/structure/cable{
	icon_state = "1-4"
	},
/turf/open/floor/plating/asteroid,
/area/ruin/unpowered)
"bo" = (
/obj/structure/cable{
	icon_state = "2-8"
	},
/turf/open/floor/plating/asteroid,
/area/ruin/unpowered)
"bp" = (
/obj/structure/cable{
	icon_state = "1-2"
	},
/turf/open/floor/plating/asteroid,
/area/ruin/unpowered)
"bq" = (
/obj/item/stack/ore/iron,
/obj/item/stack/ore/iron,
/obj/item/stack/ore/iron,
/turf/open/floor/plating/asteroid,
/area/ruin/unpowered)
"br" = (
/obj/structure/cable,
/obj/machinery/power/port_gen/pacman{
	active = 1;
	anchored = 1;
	sheets = 10
	},
/turf/open/floor/plating/asteroid,
/area/ruin/unpowered)
"bs" = (
/obj/item/stack/ore/iron,
/obj/item/stack/sheet/mineral/plasma,
/obj/item/stack/sheet/mineral/plasma,
/turf/open/floor/plating/asteroid,
/area/ruin/unpowered)
"bt" = (
/obj/structure/fluff/empty_cryostasis_sleeper,
/obj/structure/mirror{
	pixel_x = 28
	},
/turf/open/floor/mineral/titanium,
/area/ruin/powered)
"eX" = (
/obj/item/clothing/head/helmet/space/orange,
/turf/open/floor/mineral/titanium,
/area/ruin/powered)
"kU" = (
/mob/living/simple_animal/hostile/carp,
/turf/closed/mineral/random/low_chance,
/area/ruin/unpowered)
"Qy" = (
/obj/item/tank/internals/emergency_oxygen/empty,
/turf/open/floor/mineral/titanium,
/area/ruin/powered)

(1,1,1) = {"
aa
aa
aa
aa
aa
aa
aa
aa
aa
aa
aa
aa
aa
aa
aa
aa
aa
aa
aa
aa
aa
aa
aM
aa
aa
aa
aa
aa
aa
aa
aA
aO
aA
aA
aA
aA
aA
aa
aa
aa
aa
aa
aa
aa
aa
aa
aa
aa
aa
aa
"}
(2,1,1) = {"
aa
aa
aa
aa
aa
aa
aa
aa
aa
aa
aa
aa
aa
aa
aa
aa
aM
aa
aa
aa
aa
aa
aa
aa
aA
aA
aA
aA
aA
aA
ab
ab
ab
ab
ab
ab
ab
aA
aA
aA
aa
aa
aa
aa
aM
aa
aa
aa
aa
aa
"}
(3,1,1) = {"
aa
aa
aa
aa
aa
aa
aa
aa
aa
aa
aa
aa
aa
aa
aa
aa
aa
aa
aa
aa
aa
aA
aA
aA
ab
ab
ab
ab
ab
ab
ab
ab
ab
ab
ab
ab
ab
ab
ab
ab
aA
aA
aa
aa
aa
aa
aa
aa
aM
aa
"}
(4,1,1) = {"
aa
aa
aa
aa
aa
aa
aa
aa
aa
aa
aa
aa
aa
aa
aa
aa
aa
aa
aa
aa
aA
ab
ab
ab
ab
ab
ab
ab
ab
ab
ab
ab
ab
ab
ab
ab
ab
ab
ab
ab
ab
ab
aA
aa
aa
aV
aI
aX
aa
aa
"}
(5,1,1) = {"
aa
aa
aa
aa
aa
aa
aa
aa
aa
aa
aa
aa
aa
aa
aA
aA
aA
aA
aA
aA
ab
ab
ab
ab
ab
ab
ab
ab
ab
ab
ab
ab
ab
ab
ab
ab
ab
ab
ab
ab
ab
ab
ab
aA
aa
aa
aa
aa
aa
aa
"}
(6,1,1) = {"
aa
aa
aa
aa
aa
aa
aa
aa
aa
aa
aa
aa
aa
aA
ab
ab
ab
ab
aA
ab
ab
ab
ab
ab
ab
ab
ab
ab
ab
ab
ab
ab
ab
ab
ab
ab
ab
ab
ab
ab
ab
ab
ab
ab
aA
aa
aM
aa
aa
aa
"}
(7,1,1) = {"
aa
aa
aa
aa
aa
aa
aa
aa
aa
aa
aM
aa
aA
ab
ab
ab
ab
ab
ab
ab
ab
ab
ab
ab
ab
ab
ab
ab
ab
ab
ab
ab
ab
ab
ab
ab
ab
ab
ab
ab
ab
ab
ab
ab
ab
aA
aa
aa
aa
aa
"}
(8,1,1) = {"
aa
aa
aa
aa
aa
aa
ab
aa
aa
aa
aa
aM
aA
ab
ab
ab
ab
ab
ab
ab
ab
ab
ab
ab
ab
ab
ab
ab
ab
ab
ab
ab
ab
ab
ab
ae
af
ae
ab
ab
ab
ab
ab
ab
ab
ab
aA
aa
aa
aa
"}
(9,1,1) = {"
aa
aa
aa
aa
aA
ab
ab
aA
aa
aa
aa
aa
aA
ab
ab
ab
ab
ab
ab
ab
ab
ab
ab
ab
ab
ab
ab
ab
ab
ab
ab
ab
ab
ab
ab
af
aq
af
ab
ab
ab
ab
ab
ab
ab
ab
ab
aA
aa
aa
"}
(10,1,1) = {"
aa
aa
aa
aa
ab
ab
ab
ab
aA
aa
aa
aA
aA
ab
ab
ab
ab
ab
ab
ab
ab
ab
ab
ab
ab
ab
ab
ab
ab
ab
ab
ab
ab
ab
ae
ae
ao
ae
ae
ah
ab
ab
ab
ab
ab
kU
ab
aA
aa
aa
"}
(11,1,1) = {"
aa
aa
aa
aA
ab
ab
ab
ab
aA
aa
aa
aA
aA
ab
ab
ab
ab
ab
ab
ab
ab
ab
ab
ab
ab
ab
ab
ab
ab
ab
ab
ab
ab
ab
af
an
an
an
af
ah
ah
ab
ab
ab
ab
ab
ab
ab
aA
aa
"}
(12,1,1) = {"
aa
aa
aa
aA
ab
ab
ab
ab
aA
aa
aa
aA
aA
aA
ab
ab
ab
ab
ab
ab
ab
ab
ab
ab
ab
ab
ab
ab
ab
ab
ab
ab
ab
ae
ae
bh
an
an
ae
aZ
ah
ah
ab
ab
ab
ab
ab
ab
aA
aa
"}
(13,1,1) = {"
aa
aa
aa
aA
ab
ab
ab
ab
aA
aa
aa
aA
aA
aA
ab
ab
ab
ab
ab
ab
ab
ab
ab
ab
ab
ab
ab
ab
ab
ab
ab
ab
ab
af
aY
aW
ao
ao
ak
ba
ah
ah
ab
ab
ab
ab
ab
ab
aA
aa
"}
(14,1,1) = {"
aa
aa
aa
aa
ab
ab
ab
ab
aA
aa
aa
aA
aA
aA
ab
ab
ab
ab
ab
ab
ab
ab
ab
ab
ab
ab
ab
ab
ab
ab
ab
ab
ab
al
aj
ap
an
as
aj
aE
ah
ah
ab
ab
ab
ab
ab
ab
aA
aa
"}
(15,1,1) = {"
aa
aa
aa
aa
aA
ab
ab
aA
aa
aa
aa
aA
aA
aA
ab
ab
ab
ab
ab
ab
ab
ab
ab
ab
ab
ab
ab
ab
ab
ab
ab
ab
ab
af
bt
ao
ao
ao
bt
ba
ah
ah
ab
ab
ab
ab
ab
ab
aA
aa
"}
(16,1,1) = {"
aa
aa
aa
aa
aa
aa
ab
aa
aa
aa
aa
aA
aA
ab
ab
ab
ab
ab
ab
ab
ab
ab
ad
ax
ab
ab
ab
ab
ab
ab
ab
ab
aR
ae
ae
Qy
eX
an
ae
aZ
ah
ah
ab
ab
ab
ab
ab
ab
aA
aM
"}
(17,1,1) = {"
aa
aa
aa
aa
aa
aa
aa
aa
aa
aa
aa
aA
aA
ab
ab
ab
ab
ab
ab
ab
ab
ab
ah
ah
ah
ab
ab
ab
ab
ab
ab
ab
aR
ag
ag
af
ar
af
at
bb
ah
ah
ab
ab
ab
ab
ab
ab
aA
aa
"}
(18,1,1) = {"
aa
aa
aa
aa
aa
aa
aa
aa
aa
aa
aa
aA
aA
ab
ab
ab
ab
ab
ab
ab
ab
ac
ah
ah
ah
ah
ah
aH
aJ
aL
ab
ab
aT
ah
ah
ah
ah
ah
ah
ah
aR
ah
ab
ab
ab
ab
ab
ab
aA
aa
"}
(19,1,1) = {"
aa
aa
aa
aa
aa
aa
aa
aa
aa
aa
aA
aA
ab
ab
ab
ab
ab
ab
ab
ab
ab
ac
am
ah
az
aD
ah
ah
ah
ah
ab
ab
ah
ah
ah
ah
ah
ah
ah
ah
bi
ah
ab
ab
ab
ab
ab
ab
aA
aa
"}
(20,1,1) = {"
aa
aa
aa
aa
aa
aa
aa
aa
aa
aa
aA
aA
ab
ab
ab
ab
ab
ab
ab
ab
ab
ac
au
ay
aB
ah
ah
ah
ah
ah
ab
ab
ah
ah
ah
ah
ah
ah
ah
ah
ah
ah
ab
ab
ab
ab
ab
ab
aA
aa
"}
(21,1,1) = {"
aa
aa
aa
aa
aa
aa
aa
aM
aa
aa
aA
aA
ab
ab
ab
ab
ab
ab
ab
ab
ab
ac
av
ah
aC
aF
ah
ah
ah
ah
ab
ab
aU
be
ah
ah
bm
bn
ah
ah
ah
ah
ab
ab
ab
ab
ab
ab
aA
aa
"}
(22,1,1) = {"
aa
aa
aa
aa
aa
aa
aa
aa
aa
aa
aA
aA
ab
ab
ab
ab
ab
ab
ab
ab
ab
ac
aw
ah
ah
ah
aG
ah
ah
ah
ab
ab
bc
bf
ah
ah
ah
bo
bp
bp
br
ah
ab
ab
ab
ab
ab
ab
aA
aa
"}
(23,1,1) = {"
aa
aa
aa
aa
aa
aa
aa
aa
aa
aa
aA
ab
ab
ab
ab
ab
ab
ab
ab
ab
ab
ab
ah
ah
ah
ah
ab
ah
ah
ah
ab
ab
bd
bg
ah
ah
ah
ah
ah
ah
bs
ah
ab
ab
ab
ab
ab
aA
aa
aa
"}
(24,1,1) = {"
aa
aa
aa
aa
aa
aa
aa
aa
aa
aA
aA
ab
ab
ab
ab
ab
ab
ab
ab
ab
ab
ab
ab
ab
ab
ab
ab
ab
ah
ah
ab
ab
ah
ah
ah
ah
ah
ah
ah
ah
ah
ah
ab
ab
ab
ab
ab
aA
aa
aa
"}
(25,1,1) = {"
aa
aa
aa
aa
aa
aa
aa
aa
aa
aA
ab
ab
ab
ab
ab
ab
ab
ab
ab
ab
ab
ab
ab
ab
ab
ab
ab
ab
ah
ah
aN
ah
ah
ah
ah
aR
ah
ah
ah
ah
ah
ah
ab
ab
ab
ab
aA
aa
aa
aa
"}
(26,1,1) = {"
aa
aa
aa
aa
aa
aa
aa
aa
aa
aA
ab
ab
ab
ab
ab
ab
ab
ab
ab
ab
ab
ab
ab
ab
ab
ab
ab
ah
ah
ah
ab
ah
ah
ah
ah
ah
ah
ah
ah
ah
ah
ah
ab
ab
ab
ab
aa
aa
aa
aa
"}
(27,1,1) = {"
aa
aa
aa
aa
aa
aa
aa
aa
aa
aA
ab
ab
ab
ab
ab
ab
ab
ab
ab
ab
ab
ab
ab
ab
ab
ab
ah
ah
aK
ab
ab
ah
ah
ah
ah
ah
ah
ah
bq
ah
ah
aR
ab
ab
ab
aA
aa
aa
aa
aM
"}
(28,1,1) = {"
aa
aa
aa
aa
aa
aa
aa
aa
aM
aa
aA
ab
ab
ab
ab
ab
ab
ab
ab
ab
ab
ab
ab
ab
ab
ab
ah
ah
ab
ab
ab
aP
ah
ah
ah
ah
ah
ah
ah
ah
ah
aR
ab
ab
ab
aA
aa
aa
aa
aa
"}
(29,1,1) = {"
aa
aa
aa
aa
aa
aa
aa
aa
aa
aa
aA
ab
ab
ab
ab
ab
ab
ab
ab
ab
ab
ab
ab
ab
ab
ab
ab
ab
ab
ab
ab
aQ
aP
ah
ah
aR
ah
ah
ah
ah
ah
ab
ab
ab
ab
aA
aa
aa
aa
aa
"}
(30,1,1) = {"
aa
aa
aa
aa
aa
aa
aa
aa
aa
aa
aA
ab
ab
ab
ab
ab
ab
ab
ab
ab
ab
ab
ab
ab
ab
ab
ab
ab
ab
ab
ab
ab
ab
ah
ah
ah
ah
aP
ah
bi
ab
ab
ab
ab
ab
aa
aa
aa
aa
aa
"}
(31,1,1) = {"
aa
aa
aa
aa
aa
aa
aa
aa
aa
aa
aA
ab
ab
ab
ab
ab
ab
ab
ab
ab
ab
ab
ab
ab
ab
ab
ab
ab
ab
ab
ab
ab
ab
ah
ah
ah
ah
ah
ah
aS
ab
ab
ab
ab
aA
aa
aa
aa
ab
aA
"}
(32,1,1) = {"
aa
aa
aa
aa
aa
aa
aa
aa
aa
aa
aa
aA
aA
ab
ab
ab
ab
ab
ab
ab
ab
ab
ab
ab
ab
ab
ab
ab
ab
ab
ab
ab
ab
bi
ah
ah
ah
ah
ah
aS
ab
ab
ab
ab
aA
aa
aa
aO
ab
ab
"}
(33,1,1) = {"
aa
aa
aa
aa
aa
aa
aa
aa
aa
aa
aa
aa
aA
ab
ab
ab
ab
ab
ab
ab
ab
ab
ab
ab
ab
ab
ab
ab
ab
ab
ab
ab
ab
ab
ah
bl
ah
ah
ah
aS
ab
ab
ab
ab
aA
aa
aA
ab
ab
ab
"}
(34,1,1) = {"
aa
aa
aa
aa
aa
aa
aa
aa
aa
aa
aa
aa
aa
aA
ab
ab
ab
ab
ab
ab
ab
ab
ab
ab
ab
ab
ab
ab
ab
ab
ab
ab
ab
aS
bj
ah
ah
ah
aS
aS
ab
ab
ab
ab
aA
aa
aA
ab
ab
aA
"}
(35,1,1) = {"
aa
aa
aa
aa
aa
aa
aA
aA
aa
aa
aa
aa
aM
aa
aA
ab
ab
ab
ab
ab
ab
ab
ab
ab
ab
ab
ab
ab
ab
ab
ab
ab
ab
aS
ah
ah
ah
ah
aS
aS
ab
ab
ab
aA
aa
aa
aA
ab
ab
ab
"}
(36,1,1) = {"
aa
aa
aa
aa
aa
aa
ab
ab
aA
aa
aa
aa
aa
aa
aA
ab
ab
ab
ab
ab
ab
ab
ab
ab
ab
ab
ab
ab
ab
ab
ab
aA
aS
aS
aS
bk
bk
aS
aS
aS
aS
ab
ab
aA
aa
aa
aa
ab
ab
ab
"}
(37,1,1) = {"
aa
aa
aa
aa
aa
ab
ab
ab
ab
aa
aa
aa
aa
aa
aA
aA
ab
ab
ab
ab
ab
ab
ab
ab
ab
ab
ab
ab
ab
ab
aA
aA
aA
aS
aS
aS
bk
aS
aS
aS
aA
aO
ab
aA
aa
aa
aa
aa
aA
aA
"}
(38,1,1) = {"
aa
aa
aa
aa
aa
ab
ab
ab
ab
ab
aa
aa
aa
aa
aa
aA
aA
ab
ab
ab
ab
ab
ab
ab
ab
ab
ab
ab
ab
ab
aA
aA
ai
ai
ai
ai
ai
ai
ai
ai
aA
aA
ab
aA
aa
aa
aa
aa
aa
aa
"}
(39,1,1) = {"
aa
aa
aa
aa
aa
aA
ab
ab
ab
ab
aa
aa
aa
aa
aa
aa
aA
aA
ab
ab
ab
ab
ab
ab
ab
ab
ab
ab
ab
ab
aA
aa
aa
aa
ai
ai
ai
aa
ai
aa
aa
aA
ab
aA
aa
aa
aa
aa
aa
aa
"}
(40,1,1) = {"
aa
aa
aa
aa
aa
aa
aA
ab
ab
aA
aa
aa
aa
aa
aa
aa
aa
aA
aA
ab
ab
ab
ab
ab
ab
ab
ab
ab
ab
ab
ab
ab
aa
aa
aa
aa
aa
aa
ai
aa
aa
ab
ab
aA
aa
aa
aa
aa
aa
aa
"}
(41,1,1) = {"
aa
aa
aa
aa
aa
aa
aa
aa
aa
aa
aa
aa
aa
aa
aa
aa
aa
aa
aA
aA
ab
ab
ab
ab
ab
ab
ab
ab
ab
ab
ab
ab
aa
aa
aa
aa
aa
aa
aa
aa
aa
ab
ab
aA
aa
aa
aa
aa
aa
aa
"}
(42,1,1) = {"
aa
aa
aa
aa
aa
aa
aa
aa
aa
aa
aa
aa
aa
aa
aa
aa
aa
aa
aa
aA
aA
aA
aA
aA
aA
aA
aA
aA
ab
ab
ab
ab
ab
aa
aa
aa
aa
aa
aa
aa
aa
ab
aa
aa
aa
aa
aM
aa
aa
aa
"}
(43,1,1) = {"
aa
aa
aa
aa
aa
aa
aa
aa
aa
aa
aa
aa
aa
aM
aa
aa
aa
aa
aa
aa
aa
aa
aa
aa
aa
aa
aa
aA
aA
aA
aA
aO
ab
aa
aa
aa
aa
aa
aa
aa
aa
aM
aa
aa
aa
aa
aa
aa
aa
aa
"}
(44,1,1) = {"
aa
aa
aa
aa
aa
aa
aa
aa
aa
aa
aa
aa
aa
aa
aa
aa
aa
aa
aa
aa
aa
aa
aa
aa
aa
aa
aa
aa
aa
aa
aa
aa
aa
aa
aa
aa
aa
aa
aa
aa
aa
aa
aa
aa
aa
aa
aA
aa
aa
aa
"}
(45,1,1) = {"
aa
aa
aa
aa
aa
aa
aa
aa
aa
aa
aa
aa
aa
aa
aA
aa
aa
aa
aa
aM
aa
aa
aa
aa
aa
aa
aa
aM
aa
aa
aa
aa
aa
aa
aa
aa
aa
aa
aa
aa
aM
aa
aa
aa
aa
aA
ab
aA
aa
aa
"}
(46,1,1) = {"
aa
aa
aa
aa
aa
aa
aa
aa
aa
aa
aa
aa
aa
aM
ab
ab
aA
aa
aa
aa
aa
aa
aa
aa
aa
aa
aa
aa
aa
aa
aa
aa
aa
aa
aa
aa
aa
aa
aa
aa
aa
aa
aa
aa
aa
ab
ab
ab
aa
aa
"}
(47,1,1) = {"
aa
aa
aa
aa
aa
aa
aa
aa
aa
aa
aa
aa
aa
ab
ab
ab
ab
aA
aa
aa
aa
aa
aa
aa
aa
aa
aa
aa
aa
aa
aa
aa
aA
aA
aa
aa
aa
aa
aa
aa
aa
aa
aa
aa
aa
ab
ab
ab
aa
aa
"}
(48,1,1) = {"
aa
aa
aa
aa
aa
aa
aa
aa
aa
aa
aa
aa
aa
aA
ab
ab
ab
ab
aa
aa
aa
aM
aa
aa
aa
aa
aa
aa
aa
aa
aa
aA
ab
aA
aa
aa
aa
aa
aa
aa
aa
aa
aa
aa
aa
aA
ab
aA
aa
aa
"}
(49,1,1) = {"
aa
aa
aa
aa
aa
aa
aa
aa
aa
aa
aa
aa
aa
aa
aa
aA
aA
aa
aa
aa
aa
aa
aa
aa
aa
aa
aa
aa
aa
aa
aa
aM
aA
aa
aa
aa
aa
aM
aa
aa
aa
aa
aa
aa
aa
aA
aa
aa
aa
aa
"}
(50,1,1) = {"
aa
aa
aa
aa
aa
aa
aa
aa
aa
aa
aa
aa
aa
aa
aa
aa
aa
aa
aa
aa
aa
aa
aa
aa
aa
aa
aa
aa
aa
aa
aa
aa
aa
aa
aa
aa
aa
aa
aa
aa
aa
aa
aa
aa
aa
ab
aa
aa
aa
aa
"}
